0000001111001100011001111001111000000000000000
0000001000101010101010000010000000000000000000
0000001111001001001010000010000000000000000000
0000001000101000001010000010000000000000000000
0000001111001000001001111001111000000000000000
0000000000000000000000000000000000000000000000
0000000000000000000000000000000000000000000000
0000000000000000000000000000000000000000000000
0000000000000000000000000000000000000000000000
1111111111000001111101222101100101333100011141
0000000000000001000001222101010100131000000111
0000000000000001000001222101001100010000000000
0000000000000001111101111101000100010000000000